11111111111
10p00000C01
10c01001e01
11111111111