11111111111
1cpc00001c1
10c010C0E01
11111111111