11111111111
10p00c00001
10c01001Ec1
11100001101
11111111111