11111111
1c0Cep01
10c01001
11111111