11111111111
10p00000C11
10c01001E01
11100001101
11111111111