11111111111111111
10p00000C000001c1
10c0100100100c0e1
11100001101c0c111
11111111111111111